3 0 0 2 0 1 0 0 3 -2 0 2 0 1 0 0 0 0 8 0 0 6 9 2 1 6 0 0 0 3 5 0 1 0 10 0 6 8 8 0 0 0 0 4 0 5 0 1 7 0 0 0 0 1 0 6 0 3 0 5 
0 9 6 -1 2 0 0 0 0 0 0 1 0 0 0 0 1 0 -2 4 0 0 -1 10 0 3 0 1 4 -2 2 0 4 4 -1 0 10 1 8 1 0 0 0 9 0 8 5 3 9 4 0 1 0 0 10 -2 7 6 0 0 
10 0 0 0 9 10 3 -1 0 0 2 -2 8 5 5 0 2 1 0 0 1 2 0 10 0 -1 3 0 3 6 5 -1 0 0 7 9 -2 0 0 0 10 3 0 0 0 -1 4 4 5 0 0 0 -1 8 0 10 2 -1 6 -2 
9 0 3 0 0 4 0 7 0 0 0 6 0 1 0 0 0 0 7 0 0 0 0 4 -1 7 5 0 0 1 0 0 0 0 0 -1 1 0 -2 -2 0 0 2 10 5 0 2 0 0 3 0 0 0 0 0 -1 0 0 0 4 
-2 3 0 0 10 7 7 0 1 0 7 0 0 6 0 2 7 0 0 0 0 6 0 6 0 9 4 7 0 0 0 0 0 9 6 0 0 0 5 5 0 0 9 5 0 5 0 -1 2 0 0 0 6 8 0 3 0 0 0 9 
0 7 0 0 0 1 0 6 0 3 -2 9 4 0 9 0 0 0 2 1 0 0 0 8 7 0 9 0 0 4 0 -1 0 0 0 4 0 0 0 4 6 0 -2 -2 0 0 0 0 0 0 10 3 5 0 7 4 7 1 0 5 
9 5 0 4 6 0 0 8 0 4 0 8 6 7 0 0 0 7 4 0 0 0 2 2 0 10 0 0 0 0 0 0 5 0 0 0 0 0 0 0 1 0 0 9 0 0 0 0 0 0 0 0 0 0 10 0 0 1 0 0 
0 4 8 0 0 -2 0 0 0 0 0 0 9 0 7 0 0 -1 0 0 0 0 8 -1 0 0 0 0 0 0 7 0 8 6 1 0 0 0 0 0 0 -2 0 0 0 0 10 6 0 0 2 0 3 0 1 0 0 0 0 0 
0 7 8 0 0 0 -2 0 -2 -1 0 0 0 0 0 1 0 0 6 4 1 2 0 5 0 9 7 0 6 -1 0 0 4 0 10 1 0 0 0 -2 0 0 0 0 0 0 10 6 0 0 1 0 0 2 5 0 -1 -2 0 7 
0 0 2 3 0 1 0 9 0 0 0 3 1 7 10 0 9 0 10 0 5 0 1 0 8 0 0 0 0 0 3 3 10 0 0 0 -1 0 0 10 0 0 1 0 0 1 0 0 5 0 9 0 0 0 0 3 9 8 -1 0 
10 0 0 2 0 0 0 1 0 -1 0 8 0 5 1 2 2 1 2 3 0 0 0 0 0 0 0 1 0 0 0 6 0 0 6 10 -2 0 7 0 0 0 0 0 0 7 0 3 8 0 0 0 5 0 4 0 5 0 0 4 
8 9 0 0 5 0 0 4 0 0 5 0 -2 6 -1 1 0 3 9 -2 7 -1 0 6 8 -1 0 0 8 0 0 -2 3 0 0 -1 0 0 6 10 8 0 1 6 0 0 9 0 8 2 10 7 0 1 0 7 9 7 0 4 
7 0 0 1 3 0 6 5 9 7 0 0 0 0 0 7 0 3 0 0 0 0 10 9 5 0 0 0 7 10 9 0 0 0 0 0 0 0 4 0 6 7 0 0 10 0 1 0 0 0 0 2 -1 1 2 -2 -2 10 0 0 
10 10 0 9 0 -2 0 5 0 3 -2 0 0 -2 0 1 -1 4 8 7 10 0 1 8 0 0 3 6 3 10 0 0 6 4 -1 0 0 0 3 0 0 5 5 0 0 0 5 0 -2 2 9 0 8 10 8 0 2 9 0 0 
0 0 0 0 0 0 -2 1 9 0 4 1 0 10 0 2 0 10 5 0 9 0 10 -2 0 5 0 6 3 6 0 0 1 0 4 0 0 7 10 0 1 8 0 9 10 7 6 9 2 0 6 0 1 9 0 0 5 9 7 0 
0 0 0 5 -2 7 0 -1 7 10 0 0 0 7 3 5 10 0 7 0 10 0 -1 0 0 -2 0 -2 0 -2 1 0 8 0 0 8 0 0 0 2 1 0 0 7 4 0 0 0 -1 5 7 0 5 0 0 10 0 0 -1 3 
-2 5 9 0 2 5 1 -2 0 8 0 4 0 3 0 5 0 0 0 1 1 10 0 0 0 0 9 0 0 0 -2 0 9 8 0 5 0 0 0 0 0 6 -2 0 0 7 0 0 4 4 -1 -2 2 2 5 0 0 9 0 0 
7 6 10 0 10 2 0 0 0 0 0 7 0 -2 7 0 8 4 0 0 0 0 0 0 4 0 0 5 0 0 6 0 0 0 1 4 0 4 0 0 -1 1 -2 0 9 0 0 5 10 0 0 0 3 0 9 0 -1 0 7 3 
0 0 7 7 -2 0 0 4 0 0 5 2 0 0 0 0 0 0 2 0 0 0 5 3 8 0 0 5 10 0 0 0 7 0 1 0 7 0 8 0 0 0 0 0 0 0 0 0 -1 4 2 4 1 7 2 9 -1 0 6 0 
3 0 6 9 5 6 0 0 7 3 -1 0 3 0 -2 0 8 4 0 4 -2 6 6 3 1 0 0 0 10 0 0 0 8 0 0 7 9 -2 0 -1 0 10 1 9 10 0 0 1 -2 0 10 0 0 0 7 0 10 5 2 0 
0 0 0 0 0 -1 0 0 0 0 0 0 3 0 0 0 0 0 2 8 0 0 9 0 0 0 6 4 3 0 0 0 0 3 0 0 0 -2 0 0 9 0 0 6 10 5 0 0 8 0 0 4 0 5 6 0 1 0 0 0 
6 0 4 7 0 -2 7 -1 5 10 9 0 -1 4 0 0 10 0 9 7 0 0 0 0 0 9 0 -2 0 6 0 0 -2 0 0 0 7 1 0 -2 -1 0 10 0 0 6 0 0 10 1 0 0 2 0 0 8 4 0 4 4 
0 0 0 0 2 0 0 0 0 0 0 3 0 5 0 0 0 4 0 10 0 6 0 0 0 10 0 8 0 0 0 0 0 10 5 0 -1 0 10 0 0 9 9 0 0 0 0 -2 1 10 1 6 -1 2 0 0 0 0 -2 0 
5 0 -1 0 -2 0 0 7 1 0 0 0 0 -2 0 0 9 0 10 0 3 -2 -2 0 0 0 0 8 0 8 0 0 0 0 0 3 -1 8 8 0 0 2 0 0 10 7 0 0 0 0 0 -1 0 3 0 -1 0 0 0 1 
0 0 0 0 7 -1 0 0 0 3 9 0 10 2 6 0 0 0 0 4 3 4 0 0 0 10 3 -1 0 0 0 0 0 4 -2 0 0 2 0 0 0 -2 0 -2 10 9 5 6 0 1 0 0 6 0 0 0 2 0 0 0 
-1 0 2 6 0 -1 5 -2 6 0 0 0 0 -1 0 0 0 0 6 0 0 6 6 1 4 0 3 0 6 0 10 0 6 -1 0 0 4 0 -2 0 5 10 0 -2 0 3 0 0 4 6 0 0 -1 0 -1 0 0 0 7 0 
3 9 0 -2 0 6 6 -2 -1 -2 9 0 0 0 0 5 2 6 3 10 6 0 9 4 0 0 2 0 0 6 0 6 0 0 7 10 0 0 9 -1 0 0 -2 7 5 10 8 0 0 0 0 7 10 4 8 2 8 0 0 1 
9 0 0 9 0 -1 -2 0 0 0 2 -2 1 0 5 0 7 -1 0 0 7 1 0 0 10 4 2 0 0 0 -2 0 5 3 0 0 0 7 1 10 8 0 -1 4 6 7 7 1 0 0 10 1 5 0 8 10 0 3 6 4 
4 4 0 0 9 2 0 0 1 0 3 3 7 -2 10 0 0 0 0 6 2 0 0 0 0 8 3 -2 7 0 0 5 0 1 0 0 -1 9 0 0 0 0 0 0 8 0 0 0 0 9 0 2 9 0 -2 0 7 9 0 3 
0 8 0 0 0 0 0 0 0 -2 0 0 0 0 0 0 0 1 8 0 6 0 0 0 0 -1 5 0 0 0 0 10 0 0 0 0 2 0 0 0 -1 3 0 0 0 0 10 10 0 0 2 5 0 0 8 0 0 5 0 0 
0 0 0 0 3 0 0 6 -2 0 4 4 4 10 -2 0 0 0 5 0 3 0 0 -2 0 0 0 0 3 5 0 0 0 0 6 5 0 0 9 0 0 0 0 0 6 0 0 5 0 0 1 0 4 0 0 1 0 3 3 0 
5 8 0 7 0 10 0 0 2 8 0 8 8 0 1 0 0 0 0 -2 0 -1 0 -1 0 0 0 0 0 0 4 0 0 10 0 0 0 0 8 2 0 0 -1 0 0 5 0 0 -1 0 0 0 5 0 0 1 -1 0 0 1 
5 0 0 0 8 0 6 9 0 6 5 4 2 -2 0 -1 0 0 5 0 0 7 0 10 0 0 2 5 4 0 -1 2 0 0 0 0 0 0 3 10 9 2 0 1 10 2 0 -1 0 0 0 0 2 10 3 0 6 0 0 0 
3 0 2 10 0 0 4 9 2 0 5 0 0 0 0 6 -2 0 -2 0 3 0 0 0 0 1 0 0 -2 0 0 0 0 0 -1 10 0 -1 0 0 0 0 0 3 0 0 -1 6 0 0 0 -1 0 0 1 1 0 0 10 0 
0 3 0 8 0 0 5 1 0 0 0 -2 0 0 0 0 9 -1 0 0 -1 0 4 0 0 5 0 4 1 10 5 3 0 0 -1 4 5 -1 0 0 0 0 2 4 4 0 0 -2 0 0 0 0 5 6 0 0 0 0 6 2 
-2 8 6 0 6 0 0 6 0 0 6 0 5 6 0 1 1 0 0 7 0 0 6 0 -2 0 0 0 0 0 0 6 0 1 0 4 0 5 0 4 9 0 2 0 6 1 3 0 0 7 -2 0 0 0 0 0 0 3 7 8 
9 0 10 -2 4 0 0 2 0 0 10 1 3 -1 5 0 10 5 2 0 0 0 3 1 9 5 0 0 3 8 0 4 0 0 0 1 0 0 0 2 0 10 0 0 0 0 0 10 0 7 0 0 0 9 2 0 0 8 0 0 
8 0 0 0 0 5 0 9 9 0 -2 1 0 0 10 4 0 0 0 0 2 4 9 -1 0 1 6 0 0 0 6 0 0 -2 0 0 3 0 0 9 2 4 3 10 5 2 10 8 10 2 0 0 0 0 0 0 8 2 0 4 
9 8 0 0 0 0 0 -1 0 0 0 0 0 0 3 0 -1 0 0 -1 0 0 0 0 0 0 0 0 4 4 0 0 3 10 1 0 0 -2 0 0 0 0 0 3 0 0 9 0 0 0 0 0 8 3 0 0 3 0 6 0 
0 0 0 0 2 0 10 0 10 4 0 0 0 0 7 0 0 4 0 5 5 8 -1 10 -1 0 0 -1 0 0 0 0 7 0 0 1 0 0 8 0 3 9 0 6 3 1 5 0 -2 6 3 2 4 0 0 6 -2 0 0 5 
0 0 4 -1 0 0 8 0 0 -1 0 0 0 10 0 -2 0 1 3 0 5 1 0 9 2 3 0 0 0 4 7 10 0 9 8 0 2 0 5 0 -1 0 0 -2 0 0 0 0 6 0 -1 5 4 5 -1 4 0 0 8 0 
0 3 0 3 9 0 0 0 0 0 0 0 0 8 0 10 0 5 0 6 -1 0 0 0 1 0 7 0 0 0 0 5 10 0 -2 2 8 0 -1 0 0 2 0 2 10 5 6 0 2 10 0 0 9 0 3 0 0 0 0 0 
0 -2 9 7 0 -2 0 0 0 0 0 0 -1 0 4 0 0 0 0 -1 0 0 2 10 0 0 0 0 0 10 0 0 8 0 6 7 -1 2 0 2 9 8 8 0 0 0 6 0 2 -2 4 7 0 0 -1 0 -1 0 7 3 
0 10 6 7 0 10 9 0 0 0 0 4 0 5 7 0 4 -2 1 1 0 5 0 10 0 4 0 0 0 0 7 0 0 5 0 0 5 0 0 0 0 7 0 0 0 1 0 10 0 0 0 0 -2 7 0 0 5 -2 0 0 
-2 0 0 0 6 10 10 0 8 0 0 0 0 3 9 0 0 0 4 0 0 9 2 0 0 0 -1 0 6 -1 2 0 -1 8 9 0 8 0 0 0 -1 3 0 0 0 2 0 0 0 -1 0 0 0 0 1 0 0 0 0 0 
5 5 -2 0 0 5 0 0 3 0 0 9 0 0 0 9 0 8 0 -1 0 -2 5 0 0 0 4 4 0 0 0 1 0 4 0 0 2 0 -1 0 3 0 4 -1 0 5 8 0 0 7 0 1 2 10 0 2 5 0 1 10 
0 0 8 0 0 6 5 -1 0 7 6 5 0 0 -2 -2 0 2 0 6 0 1 0 0 0 2 0 0 3 8 4 0 0 0 0 0 9 5 0 0 0 0 0 3 0 0 0 0 7 0 9 0 0 9 0 5 0 0 2 8 
0 4 0 0 -2 10 0 0 0 0 0 0 1 6 4 0 0 0 0 3 0 6 0 0 0 0 0 0 0 0 -2 0 0 3 9 10 2 1 10 0 8 9 0 2 0 0 0 2 1 0 0 0 6 4 0 9 0 -2 0 0 
1 9 0 4 4 9 0 0 0 6 8 0 0 0 0 0 0 7 9 0 0 -2 0 8 0 0 8 0 0 0 0 0 0 0 0 0 0 0 6 5 0 0 5 9 -2 0 4 1 9 9 8 0 0 8 0 10 9 0 7 5 
3 0 0 0 0 0 2 0 0 0 0 0 1 0 0 0 9 8 -2 0 0 4 0 0 0 -2 9 8 0 7 3 8 7 4 7 0 -1 9 0 8 0 6 2 9 0 1 0 3 0 0 7 7 8 0 0 0 3 2 0 2 
